*** ****4*
*        *
*2** *****
*        *
** ***** *
*        *
* *** ** *
*        *
**** ***6*
** ***** *
*        *
* **2* * *
*        *
* * * ** *
*        *
*** ****8*
*        *
******** *
*        *
* **** ***
*        *
**6* ** **
*        *
**********