* *9* ** *
* * ***8**
* **** ***
** * * * *
**** **6**
* ** ** **