*** **7* *
** *** ***
*** ** * *
**7*** ***
*** ***7**